1111111111111111111111111111111111
1000000001111111111111111111111111
11111111C0000011111111111111111111
1111111111111000000000000011111111
1111111111111111111111111011111111
1111111111111111111111111011111111
1111111111111111111111111011111111
1111111111111111111111111011111111
1111111111111111111111111C11111111
1111111111111111111111111011111111
1111111111111111111111111C11111111
11111111111111111111C0000011111111
1111111111111111111111111111111111